Michael Sembello - Maniac - From "Flashdance" Soundtrack
Soft Cell - Tainted Love
The Pointer Sisters - I'm So Excited
Partenaire Particulier - Partenaire Particulier
Cyndi Lauper - Girls Just Want to Have Fun
Queen - Another One Bites The Dust - Remastered 2011
Eurythmics - Sweet Dreams (Are Made of This) - Remastered
Indochine - L'aventurier
Kate Bush - Running Up That Hill (A Deal With God)
a-ha - Take on Me
Nena - 99 Luftballons
Bandolero - Paris Latino - Original Version 1983
George Benson - Give Me the Night
Kim Carnes - Bette Davis Eyes
The Police - Every Breath You Take
Michael Jackson - Beat It
Gilbert Montagné - On va s'aimer
Paul Young - Every Time You Go Away - Radio Edit
Diana Ross - Upside Down
Jean-Jacques Goldman - Je te donne
Elton John - I'm Still Standing
Orchestral Manoeuvres In The Dark - Enola Gay
Téléphone - Ça (c'est vraiment toi) - Remasterisé en 2015
Scorpions - Still Loving You
Jermaine Jackson - When the Rain Begins to Fall
Jean-Pierre Mader - Macumba (Version 45T)
Wham! - Wake Me Up Before You Go-Go
Madonna - La Isla Bonita
Indochine - Trois nuits par semaine
Berlin - Take My Breath Away (as heard in Top Gun) (Re-Recorded / Remastered)
Kenny Loggins - Footloose - From "Footloose" Soundtrack
Indeep - Last Night a D.J. Saved My Life
Gold - Plus près des étoiles
Talk Talk - Such a Shame
Queen - I Want To Break Free - Single Remix
Imagination - Just an Illusion
The Weather Girls - It's Raining Men
The Clash - Should I Stay or Should I Go - Remastered
France Gall - Ella, elle l'a
Irene Cara - Flashdance...What a Feeling - Radio Edit
Kool & The Gang - Get Down On It - Single Version
Philip Bailey - Easy Lover
Bronski Beat - Smalltown Boy
Europe - The Final Countdown
F.R. David - Words - Original Version 1983
Les Rita Mitsouko - Marcia Baïla
U2 - Sunday Bloody Sunday - Remastered 2008
Miami Sound Machine - Conga!
Yazoo - Don't Go
Hervé Cristiani - Il est libre Max
Earth, Wind & Fire - Let's Groove
Stevie Wonder - Part-Time Lover
Jean-Jacques Goldman - Au bout de mes rêves
Tina Turner - What's Love Got to Do with It - 2015 Remaster
Kool & The Gang - Fresh
Depeche Mode - Just Can't Get Enough
UB40 - I Got You Babe
Rick Astley - Never Gonna Give You Up
Phil Collins - You Can't Hurry Love - 2016 Remaster
Mylène Farmer - Sans contrefaçon - Girl Remix
TOTO - Africa
Blondie - Call Me
Téléphone - New-York avec toi - Remasterisé en 2015
Status Quo - In The Army Now
Captain Sensible - Wot
Alphaville - Big in Japan - Best Of
France Gall - Résiste
Fine Young Cannibals - She Drives Me Crazy
Tears For Fears - Everybody Wants To Rule The World
Cock Robin - The Promise You Made
Whitney Houston - I Wanna Dance with Somebody (Who Loves Me)
Nik Kershaw - The Riddle
Rose Laurens - Africa
Daryl Hall & John Oates - Maneater
Sting - Englishman In New York
Culture Club - Do You Really Want To Hurt Me
The Cure - Close To Me
Rod Stewart - Baby Jane
Van Halen - Jump
Niagara - Je dois m'en aller
