ZZ Top - La Grange - 2005 Remaster
AC/DC - Back In Black
KISS - I Was Made For Lovin' You
Lynyrd Skynyrd - Sweet Home Alabama
The Animals - House of the Rising Sun
U2 - Sunday Bloody Sunday - Remastered 2008
The Police - Roxanne
Dire Straits - Sultans Of Swing
Ram Jam - Black Betty
Oasis - Wonderwall
Joan Jett & The Blackhearts - I Love Rock 'N Roll
Aerosmith - Dream On
The Rolling Stones - Paint It, Black
Nirvana - Smells Like Teen Spirit
Red Hot Chili Peppers - Under the Bridge
Deep Purple - Smoke On The Water - Remastered 2012
Eric Clapton - Cocaine
Queen - We Will Rock You - Remastered 2011
Radiohead - Creep
Scorpions - Still Loving You
TRUST - Antisocial
Led Zeppelin - Whole Lotta Love - 1990 Remaster
Creedence Clearwater Revival - Fortunate Son
The Cure - Boys Don't Cry
Eagles - Hotel California - 2013 Remaster
Genesis - I Can't Dance - Remastered 2007
Black Sabbath - Paranoid
Chuck Berry - Johnny B. Goode
Midnight Oil - Beds Are Burning
Blondie - Call Me
T. Rex - Get It On
The Doobie Brothers - Long Train Runnin'
Iggy Pop - The Passenger
Rage Against The Machine - Killing In The Name
Jimi Hendrix - All Along the Watchtower
The Knack - My Sharona
Status Quo - In The Army Now
The Kinks - You Really Got Me - Mono Mix
The Who - Behind Blue Eyes
Simple Minds - Don't You (Forget About Me)
George Harrison - Got My Mind Set On You - Remastered 2004
Steppenwolf - Born To Be Wild
The Beatles - Come Together - Remastered
Ted Nugent - Stranglehold
Van Halen - Jump - 2015 Remaster
Yes - Owner of a Lonely Heart
Alice Cooper - School's Out
Téléphone - Ça (c'est vraiment toi) - Remasterisé en 2015
The Clash - London Calling - Remastered
Blue Öyster Cult - (Don't Fear) The Reaper
Boston - More Than a Feeling
The Beach Boys - I Get Around (Mono)
Journey - Don't Stop Believin'
Ramones - Blitzkrieg Bop - 2016 Remaster
Europe - The Final Countdown
Roy Orbison - Oh, Pretty Woman
Soundgarden - Black Hole Sun
David Bowie - Heroes - 2017 Remaster
Pearl Jam - Alive
Billy Idol - Rebel Yell
Survivor - Eye of the Tiger
Bruce Springsteen - Born In The U.S.A.
Buffalo Springfield - For What It's Worth
The Turtles - Happy Together
Patti Smith - Because the Night
TOTO - Africa
The Doors - Break on Through (To the Other Side)
The Stranglers - Golden Brown
Def Leppard - Pour Some Sugar On Me - Remastered 2017
Fleetwood Mac - Go Your Own Way - 2004 Remaster
Supertramp - Give A Little Bit
Pink Floyd - Comfortably Numb - 2011 Remastered Version
Elvis Presley - Hound Dog
The Stooges - I Wanna Be Your Dog
Jefferson Airplane - Somebody to Love
